20
0001122211
1110002001
0120212012
1121221000
2121102002